10 10
##### ####
# O      #
#   X X  #
#   O O  #
         O
#        #
##### ####
##### ####
#####@####
#####O####