10 10
##########
#XXX#  ###
#O   O ###
#@  O O ##
##O##O####
## ## ####
##########
##########
##########
##########