10 10
##########
#XXX######
#OOO######
# @ ######
#        #
#        #
#        #
#        #
#        #
##########