7 7
#######
# XXX #
# OOO #
#  @  #
#     #
#     #
#######
