10 10
##########
#  XXXX  #
#  OOOO  #
#   @    #
#        #
#        #
#        #
#        #
#        #
##########
