14 14
##### ########
#        #####
#   XXX  #####
#   OOO  #####
   P    @#####
         #####
##### ########
##### ########
##### ########
##### ########
##### ########
##### ########
##############
##############

4 3 1
4 2 1
6 2 2
6 3 2
5 2 0
5 3 0